11111111111111111111111111111111
1P000000100000100000000000000001
10110010101010000000100000000001
1010000010001000000010E001000001
10101110100010000000100001000001
1010000C000010000000C00001000001
10010010100010000000100001000001
11010100100010000000100E00000001
100101001000100000001001000C0001
10000100100010000000000100000001
10111100110010000000000100000001
100000C0110000100000000000000001
11111111111111111111111111111111