11111111111111111111111111111111
1P000000100000100000000000000001
10110010101010000000100000000001
10100C0010001000000010F001000001
1010111010F010F00000100001000001
1010000C000010000C11C011110C0001
10010C10100010000000100001000001
11010100100010C00111100F00000001
100101001F00100000001001000C0101
1000010010001000F000000100010001
1011110C11001000000F000100011C01
100000C011000010000000010001EC01
11111111111111111111111111111111