1111111111111111111111111111111111
1E0000000F00000C00000C000000000001
101001010010000010100100F000F10101
101001001F1010100010010000F0010101
1P0000000C00C000F000000000000000C1
1111111111111111111111111111111111