1111111111111
10C10000000C1
101001000C001
1P0C01E000001
1101111000101
1101101000111
1101101111011
1110001000011
1100101001111
1101101100011
1111101111011
1111111111111