1111111111111
10C10F0F0F0C1
101001000C001
1P0C01E000001
1101111C01001
11011011C1011
110C100011011
1110101000011
1100100101111
1101110100111
1100000010C11
1111111111111