11111111
100F0001
10FPF001
10000001
10000F01
10000001
100C00E1
11111111